
abe	安倍	あべ
abe	阿部	あべ
adachi	安達	あだち
adati	安達	あだち
aida	相田	あいだ
aihara	相原	あいはら
aikawa	合川	あいかわ
aikawa	哀川	あいかわ
aikawa	愛川	あいかわ
aikawa	愛河	あいかわ
aikawa	相川	あいかわ
aikawa	藍川	あいかわ
aikawa	逢川	あいかわ
ainama	豊崎愛生	あいなま
aizawa	相沢	あいざわ
aizawa	相澤	あいざわ
akai	赤井	あかい
akaike	赤池	あかいけ
akaishi	赤石	あかいし
akaisi	赤石	あかいし
amano	天野	あまの
andou	安藤	あんどう
anndou	安藤	あんどう
aoba	青葉	あおば
aoi	蒼井	あおい
aoki	青木	あおき
aoki	あおき	あおき
aono	青野	あおの
aoyama	青山	あおやま
asahina	朝比奈	あさひな
asakura	朝倉	あさくら
asano	浅野	あさの
asou	麻生	あそう
chiba	千葉	ちば
chihara	茅原	ちはら
chiji	辻	つじ
eguchi	江口	えぐち
eguti	江口	えぐち
endou	遠藤	えんどう
gotou	後藤	ごとう
harada	原田	はらだ
hayashibara	林原	はやしばら
hayasibara	林原	はやしばら
hidaka	日高	ひだか
hirano	平野	ひらの
horie	堀江	ほりえ
huruya	古谷	ふるや
igarashi	五十嵐	いがらし
igarasi	五十嵐	いがらし
iida	飯田	いいだ
iijima	飯島	いいじま
iino	飯野	いいの
ikeda	池田	いけだ
imai	今井	いまい
inoue	井上	いのうえ
ishida	石田	いしだ
ishiduka	石塚	いしづか
ishihara	石原	いしはら
ishii	石井	いしい
ishikawa	石川	いしかわ
isida	石田	いしだ
isiduka	石塚	いしづか
isihara	石原	いしはら
isii	石井	いしい
isikawa	石川	いしかわ
itou	伊東	いとう
itou	伊藤	いとう
izumi	泉	いずみ
kadowaki	門脇	かどわき
kaida	甲斐田	かいだ
kaihara	海原	かいはら
kaihara	貝原	かいはら
kamiya	神谷	かみや
kanda	神田	かんだ
kaneda	金田	かねだ
kannda	神田	かんだ
kasahara	笠原	かさはら
kataoka	片岡	かたおか
katou	加藤	かとう
kawahara	川原	かわはら
kawamura	川村	かわむら
kawasumi	川澄	かわすみ
kazama	風間	かざま
kikuchi	菊池	きくち
kikuti	菊池	きくち
kimura	木村	きむら
kinoshita	木下	きのした
kinosita	木下	きのした
kisaragi	如月	きさらぎ
kiyokawa	清川	きよかわ
kobayashi	小林	こばやし
kobayasi	小林	こばやし
koike	小池	こいけ
komatsu	小松	こまつ
komatu	小松	こまつ
komiya	小宮	こみや
kondou	近藤	こんどう
konndou	近藤	こんどう
konnno	今野	こんの
konnno	近野	こんの
koumoto	河本	こうもと
kousaka	高坂	こうさか
koyama	小山	こやま
koyasu	子安	こやす
kubota	窪田	くぼた
kubota	久保田	くぼた
kugimiya	釘宮	くぎみや
kugyu	釘宮理恵	くぎみやりえ
kujira	くじら
kuramochi	倉持	くらもち
kuramoti	倉持	くらもち
kurata	倉田	くらた
kuwashima	桑島	くわしま
kuwasima	桑島	くわしま
kuwatani	桑谷	くわたに
matsuda	松田	まつだ
matsuoka	松岡	まつおか
matuda	松田	まつだ
matuoka	松岡	まつおか
mitsuishi	三石	みついし
mitsuisi	三石	みついし
mituishi	三石	みついし
mituisi	三石	みついし
mizuki	水樹	みずき
nabatame	生天目	なばため
nagai	永井	ながい
nakamura	中村	なかむら
naruse	成瀬	なるせ
naruse	鳴瀬	なるせ
nonaka	野中	のなか
ochiai	落合	おちあい
ogata	緒方	おがた
ogawa	小川	おがわ
okada	岡田	おかだ
okamoto	岡本	おかもと
okamura	岡村	おかむら
ono	小野	おの
oohara	大原	おおはら
oosaka	逢阪	おおさか
ooyama	大山	おおやま
orikasa	折笠	おりかさ
otiai	落合	おちあい
ousaka	逢坂	おうさか
ozaki	尾崎	おざき
saitou	斉藤	さいとう
saitou	斎藤	さいとう
sakamoto	坂本	さかもと
sakuma	佐久間	さくま
sasaki	佐々木	ささき
satou	佐藤	さとう
seki	関	せき
sekiguchi	関口	せきぐち
sekiguti	関口	せきぐち
sekine	関根	せきね
shiina	椎名	しいな
shimizu	清水	しみず
shimura	志村	しむら
shiozawa	塩沢	しおざわ
shiraishi	白石	しらいし
siina	椎名	しいな
simizu	清水	しみず
simura	志村	しむら
siozawa	塩沢	しおざわ
siraisi	白石	しらいし
sonoda	園田	そのだ
sudou	須藤	すどう
sugimoto	杉本	すぎもと
sugita	杉田	すぎた
suzuki	鈴木	すずき
tachiki	立木	たちき
takada	高田	たかだ
takahashi	高橋	たかはし
takahasi	高橋	たかはし
takamori	高森	たかもり
takata	高田	たかた
takayama	高山	たかやま
tamura	田村	たむら
tanaka	田中	たなか
tange	丹下	たんげ
taniguchi	谷口	たにぐち
taniguti	谷口	たにぐち
tannge	丹下	たんげ
tatiki	立木	たちき
teduka	手塚	てづか
tetsuka	手塚	てつか
tetuka	手塚	てつか
tiba	千葉	ちば
tihara	茅原	ちはら
tiji	辻	つじ
toda	戸田	とだ
tominaga	冨永	とみなが
toudou	藤堂	とうどう
toyosaki	豊崎	とよさき
tsubaki	椿	つばき
tsuda	津田	つだ
tubaki	椿	つばき
tuda	津田	つだ
uchida	内田	うちだ
ueda	上田	うえだ
ueda	植田	うえだ
uehara	上原	うえはら
utida	内田	うちだ
wakamoto	若本	わかもと
yamada	山田	やまだ
yamadera	山寺	やまでら
yamaguchi	山口	やまぐち
yamaguti	山口	やまぐち
yamano	山野	やまの
yamanoto	山本	やまもと
yamasaki	山崎	やまさき
yamazaki	 山崎	やまざき
yoshida	吉田	よしだ
yosida	吉田	よしだ
yukana	ゆかな
